1111111111111111111111
1111011C00000000000001
1E1001C000000000000001
1C000011C00000000C0001
1P00000C000000000000C1
1111111111111111111111