11111111111111
111101100000C1
11100100000111
10000011000011
1P0C00000000E1
11111111111111