11111111111
10000000001
1E000000001
1C000000001
1P000000001
11111111111