11111111111
1111011C001
1E1001C0001
1C00000C001
1P00000C001
11111111111